****************************************************
*........... **......... **..........**............*
*.****.*****.**.********.**.********.**.*****.****.*
*.*  *.*   *.**.*.     *.**.*.     *.**.*   *.*. *.*
*.**** *****.**.********.**.********.**.*****.****.*
*..................................................*
*.****.**.********.**.********.**.********.**.****.*
*.****.**.********.**.********.**.********.**.****.*
*......**....**....**....**....**....**....**......*
******.**.**.**.********.**.********.**.**.**.******
     *.**.**.**.********.**.********.**.**.**.*
     *.**.**.......**..........**....  .**.**.*
     *.**.**.*****.**.***--***.**.*****.**.**.*
******.**.**.*****.**.*      *.**.*****.**.**.******
      .......**.......*      *.......**.......
******.**.*****.*****.*      *.*****.*****.**.******
     *.**.***** *****.********.*****.*****.**.*
     *.**..........**..........**..........**.*
     *.**.********.**.********.**.********.**.*
******.**.********.**.********.**.********.**.******
*............**..........**..........**............*
*.****.*****.**.********.**.********.**.*****.****.*
*.****.*****.**.********.**.********.**.*****.****.*
*...**........................................**...*
***.**.**.********.**.********.**.********.**.**.***
***.**.**.********.**.********.**.********.**.**.***
*......**....**....**....**....**....**....**......*
*.**********.**.********.**.********.**.**********.*
*.**********.**.********.**.********.**.**********.*
*..................................................*
****************************************************