****************************
.......**..........**.......
******.**.********.**.******
******.**.********.**.******
*............**............*
*.*******.**.**.**.*******.*
*.*******.**.**.**.*******.*
*.**......**.**.**......**.*
*.**.****.**....**.****.**.*
*.**.****.********.****.**.*
*......**.********.**......*
******.**..........**.******
******.**.***--***.**.******
*......**.*      *.**......*
*.****.**.*      *.**.****.*
*.****....*      *....****.*
*...**.**.********.**.**...*
***.**.**..........**.**.***
  *.**.****.****.****.**.*
  *.**.****.*  *.****.**.*
  *.........*  *.........*
  *.*******.*  *.*******.*
***.*******.****.*******.***
.......**..........**.......
***.**.**.********.**.**.***
***.**.**.********.**.**.***
*...**.......**.......**...*
*.****.*****.**.*****.****.*
*.****.*****.**.*****.****.*
*..........................*
****************************