      ****************
      *..............*
      *.**.******.**.*
      *.**.******.**.*
      *.**...**...**.*
      *.****.**.****.*
*******.****.**.****.*******
........**........**........
***.******.******.******.***
***.******.******.******.***
*.......**...**...**.......*
*.*****.****.**.****.*****.*
*.*****.****.**.****.*****.*
*o...**..............**...o*
****.****.***--***.****.****
****.****.*xxxxxx*.****.****
..**......*xxxxxx*......**..
*.**.****.*xxxxxx*.****.**.*
*....****.********.****....*
*.**.**..............**.**.*
*.**.**.************.**.**.*
*.**.**.************.**.**.*
..**.**......**......**.**..
****.*******.**.*******.****
****.*******.**.*******.****
*..........................*
*.**.******************.**.*
*.**.*                *.**.*
*.**.*                *.**.*
*.**.*                *.**.*
*o...*                *...o*
******                ******
