****************************
*............**............*
*.****.*****.**.*****.****.*
*o*  *.*   *.**.*   *.*  *o*
*.****.*****.**.*****.****.*
*..........................*
*.****.**.********.**.****.*
*.****.**.********.**.****.*
*......**....**....**......*
******.*****.**.*****.******
     *.*****.**.*****.*
     *.**          **.*
     *.** ***--*** **.*
******.** *xxxxxx* **.******
      .   *xxxxxx*   .
******.** ******** **.******
     *.**          **.*
     *.** ******** **.*
******.** ******** **.******
*............**............*
*.****.*****.**.*****.****.*
*.****.*****.**.*****.****.*
*o..**................**..o*
***.**.**.********.**.**.***
***.**.**.********.**.**.***
*......**....**....**......*
*.**********.**.**********.*
*.**********.**.**********.*
*..........................*
****************************
