****************************
*..........................*
*.**.****.********.****.**.*
*.**.****.********.****.**.*
*.**......**....**......**.*
*.****.**.**.**.**.**.****.*
*.****.**.**.**.**.**.****.*
*......**....**....**......*
***.********.**.********.***
  *.********.**.********.*
  *....**..........**....*
***.**.**.***--***.**.**.***
....**.**.*      *.**.**....
******....*      *....******
******.**.*      *.**.******
....**.**.********.**.**....
***.**.**..........**.**.***
  *....*****.**.*****....*
  *.**.*****.**.*****.**.*
  *.**.......**.......**.*
  *.*****.**.**.**.*****.*
***.*****.**.**.**.*****.***
*.........**....**.........*
*.**** **.********.**.****.*
*.****.**.********.**.****.*
*.**...**..........**...**.*
*.**.*******.**.*******.**.*
*.**.*******.**.*******.**.*
*............**............*
****************************