****************************
*......**..........**......*
*.****.**.********.**.****.*
*.****.**.********.**.****.*
*..........................*
***.**.*****.**.*****.**.***
***.**.*****.**.*****.**.***
....**.......**.......**....
***.*****.********.*****.***
  *.*****.********.*****.*
  *......................*
  *.*****.***--***.*****.*
  *.*****.*      *.*****.*
  *.**....*      *....**.*
  *.**.**.*      *.**.**.*
***.**.**.********.**.**.***
.......**..........**.......
***.********.**.********.***
  *.********.**.********.*
  *..........**..........*
  *.*****.********.*****.*
***.*****.********.*****.***
*..........................*
*.****.*****.**.*****.****.*
*.*  *.*****.**.*****.*  *.*
*.*  *.**....**....**.*  *.*
*.*  *.**.********.**.*  *.*
*.****.**.********.**.****.*
*..........................*
****************************