****************************
*.........**....**.........*
*.*******.**.**.**.*******.*
*.*******.**.**.**.*******.*
*.**.........**.........**.*
*.**.**.****.**.****.**.**.*
*....**.*  *.**.*  *.**....*
****.**.****.**.****.**.****
****.**..............**.****
.....****.********.****.....
*.**.****.********.****.**.*
*.**....................**.*
*.****.**.***--***.**.****.*
*.****.**.*      *.**.****.*
*......**.*      *.**......*
*.**.****.*      *.****.**.*
*.**.****.********.****.**.*
*.**....................**.*
*.****.*****.**.*****.****.*
*.****.*****.**.*****.****.*
*......**....**....**......*
***.**.**.********.**.**.***
***.**.**.********.**.**.***
*...**................**...*
*.****.*****.**.*****.****.*
*.****.*****.**.*****.****.*
*......**....**....**......*
*.****.**.********.**.****.*
*.****.**.********.**.****.*
*......**..........**......*
****************************